border_size=1
usage=map

Mm, Mm, Hh, Hh, Gd, Gg, Gs, Gg, Hh, Re, Hh, Gg, Gg, Gg, Gs, Gg, Gs, Gg, Gs, Gg, Gs, Gg, Gg, Gg, Gg, Gg, Gg, Gg, Gg, Gg, Gg, Gg, Gg, Gg, Gg, Gd, Hh, Rrc, Hh, Gg, Gg, Gg, Gg, Gg, Gg, Gg
Mm, Mm, Hh, Hh, Gd, Gd, Gd, Hh, Hh, Re, Gs, Gs, Gs, Gg, Gll, Gs, Gll, Gs, Gs, Gs, Gll, Gg, Gll, Gg, Gg, Gg, Gg, Gg, Gg, Gg, Gs, Gs, Hh, Gs, Gs, Gd, Gd, Rrc, Gd, Gg, Gll^Fdf, Gg, Gg, Gll^Fdf, Gg, Gg
Mm, Mm, Hh, Hh, Gd, Gd, Gd, Gs, Gs, Re, Gs, Gs, Gs, Gll, Gll^Em, Gll, Gll^Fp, Gll^Emf, Gll^Fp, Gll, Gll^Fp, Gll, Gll^Fp, Gll^Fp, Gll^Fp, Gll^Fp, Gll^Fp, Gg, Gll^Fp, Gg, Gll, Gs, Gd, Hh, Gd, Gs, Rrc, Rrc, Hh, Gd, Gs, Gs, Gg, Gg, Gg, Gg
Hh, Hh, Hh, Hh, Gd, Gd, Gs, Gs, Gs, Re, Hh, Gs, Gll, Gll, Gll^Em, Gll^Fp, Gll^Fp, Gll^Fp, Gll^Fp, Gll^Fp, Gll^Fp, Gll^Fp, Gll^Fp, Gll^Fp, Gll^Fp, Gll^Fp, Gll^Fp, Gll^Fp, Gll^Fp, Gll^Fp, Gll, Gll, Gd, Gd, Gs, Rrc, Gs, Hh, Gll, Gs, Gll^Fp, Gs, Gll^Fp, Gll^Fp, Gll^Fp, Gll^Fp
Hh, Hh, Gd, Gd, Gs, Gs, Gg, Hh, Re, Re, Hh, Gg, Gll, Gll, Gll, Gll^Fp, Gll^Fp, Gll^Fp, Gll^Fp, Gll^Fp, Gll^Fp, Gg^Fet, Gll^Fp, Gll^Fp, Gll^Fp, Gll^Fp, Gll^Fp, Gll^Fp, Gll^Fp, Gll^Fp, Gs, Gd, Hh, Gs, Gs, Rrc, Gs, Gll, Gll, Gll^Fp, Gll^Fp, Gll^Fp, Gll^Fp, Gll^Fp, Gll^Fp, Gll^Fp
Gd, Gd, Gd, Gd, Gs, Gs, Gg, Gg, Gg^Es, Re, Re, Gs, Gs, Gll, Gs^Em, Gll^Fp, Gll^Fp, Gll^Fp, Gll^Fp, Gll^Fp, Gll^Fp, Gll^Fp, Gll^Fp, Gll^Fp, Gll^Fp, Gll^Fp, Gll^Fp, Gll^Fp, Gll^Fp, Gll^Fp, Gs, Gd, Gd, Gs, Gs, 1 Kh, Gg, Gll, Gs, Gll^Fp, Gll^Fp, Gll^Fp, Gll^Fp, Gll^Fp, Gg^Fet, Gll^Fmf
Gs, Gd, Gs, Gs, Gs, Gs, Gs, Gg, Gg, Gg, Re, Gs, Gs, Gs, Gs^Em, Gll^Fp, Gs^Em, Gll^Fp, Gs, Gll^Fp, Gll^Fp, Gll^Fp, Gll^Fmf, Gll^Fmf, Gll^Fmf, Gg^Fet, Gll^Fmf, Gll^Fp, Gll^Fmf, Gll^Fp, Gll, Gs, Gs, Gs, Gs, Re, Gg, Gg, Gs, Gll, Gll, Gll^Fp, Gll^Fp, Gll^Fp, Gll^Fmf, Gll^Fmf
Gd, Gs, Gs, Gs, Gs, Gs, Gs, Gs, Gg, Gg, Gg^Es, Re, Gg, Gs, Gs, Gs, Gg, Gs, Gll, Gll^Emf, Gll^Fmf, Gll^Fmf, Gll^Fmf, Gll^Fmf, Gll^Fmf, Gll^Fmf, Gll^Fmf, Gll^Fmf, Gll^Fmf, Gll^Fmf, Gll, Gll, Gg, Gs, Gs, Re, Gg, Gd, Gd, Gs, Gll^Fmf, Gll^Fmf, Gll^Fmf, Gll^Fmf, Gll^Fmf, Gll^Fmf
Hh, Gd, Gs, Gs, Gs, Gs, Gs, Gs, Gg, Gg, Re, Re, Re, Gg, Gg^Efm, Gg, Gg^Efm, Gg, Gg, Gll^Emf, Gll^Fmf, Gll^Fmf, Gll^Fmf, Gll^Fmf, Gll^Fmf, Gll^Fmf, Gll, Gll^Fmf, Gll^Fmf, Gll^Fmf, Gll, Gll, Gg, Gg, Gg, Re, Gs, Gd, Hh, Gs, Gs, Gll^Fmf, Gll^Fmf, Gll^Fmf, Gll^Fmf, Gll^Fmf
Re, Gd, Re, Re, Re, Gs, Re, Gg, Re, Re, Gs, Gs, Gg^Efm, Re, Re, Gg^Efm, Gg^Efm, Gg, Gg, Gll^Fmf, Gll^Fmf, Gll^Fmf, Gll^Fmf, Gll^Fmf, Gs, Gll^Fmf, Gll, Gll, Gll, Gll, Gll, Gll, Gg^Gvs, Gg^Gvs, Gg, Re, Gs, Gs, Gg, Gs, Gs, Gs, Gs, Gll^Fmf, Gg, Gg
Gd, Re, Gd, Gd, Gs, Re, Gs, Re, Gg, Gs, Gs, Gs, Gg^Efm, Gg^Efm, Gg^Efm, 3 Kv, Gg^Efm, Gg^Efm, Gg, Gs, Gll^Fmf, Gll^Fmf, Gll^Fmf, Gs, Gs, Gs, Gg, Gll, Gg, Gll, Gs, Gg, Gg, Gg, Re, Re, Gg, Gg, Gg, Gg, Gg, Gs, Gg, Gg, Gg, Gg
Gd, Hh, Gd, Gd, Gg, Gs, Gg, Gg, Gg^Gvs, Gg, Gg, Gg, Gg, Gg^Efm, Gg^Efm, Re, Gg^Efm, Gg^Efm, Gg, Gs, Gs, Gll^Fmf, Gs, Gs, Gs, Gg, Gg, Gg, Gg, Gs, Gs, Gs, Re, Re, Gg, Gg, Gg, Gg, Gg^Gvs, Gg, Gg, Gg, Gg, Gg, Gs^Es, Gg
Gg, Gd, Gg, Gg, Gg, Gg, Gg, Gg^Gvs, Gg^Gvs, Gg^Gvs, Gg, Gg, Gg, Gg, Gg, Re, Gg, Gg, Gg, Gg, Gg, Gs, Gg, Gs, Gg, Gg, Gg, Gg, Gg, Gs, Gs, Re, Gg, Gg, Gg, Gg, Gg, Gg^Gvs, Gg^Gvs, Gg^Gvs, Gg, Gg, Gs^Es, Gs, Gs, Gg
Gg, Gg, Gg, Gg, Gll, Gg, Gg, Gg, Gg, Gg, Gg, Gg, Gg^Gvs, Gg, Gg, Re, Re, Gg, Re, Gg, Gg, Gg, Gg, Gg, Gg, Gg, Gs, Gs, Gg, Gg, Gg, Re, Gs, Gs, Gs, Gg, Gg, Gg, Gg, Gg, Gg, Gs, Gs, Gs, Gs, Gs
Gg, Gg, Gg, Gll, Gll, Gll, Gll^Fdf, Gll, Gll^Fdf, Gll, Gg, Gg^Gvs, Gg, Gg, Gs, Gs, Gs, Re, Gs^Es, Re, Re, Gg, Hh, Gg, Re, Gg^Es, Gs, Gs, Gg, Gg, Gg, Re, Gs, Gs, Gs, Gg, Gg, Gg, Gg, Gg, Gg, Gs^Em, Gs^Em, Gs, Gs^Em, Gs
Gd, Gd, Gd, Gll, Gll^Fdf, Gll^Fdf, Gll^Fdf, Gll^Fdf, Gll^Fdf, Gll, Gll, Gg, Gg, Gg, Gs, Gs, Gs, Hh, Gg, Gs, Gs^Es, Re, Re, Re, Gd^Es, Re, Re, Gs, Gs, Gg^Es, Re, Re, Gs, Gs, Gg, Gg, Gg, Gg, Gg, Gg, Gll^Fp, Gll^Fp, Gll^Fp, Gs, Gll^Fp, Gs^Em
Gd, Gd, Gd, Gd, Gll^Fdf, Gll^Fdf, Gll^Fdf, Gll^Fdf, Gd, Gll, Gll, Gg, Gg, Gg, Gg, Gg, Gg, Gg, Gg, Gg, Gg, Gg, Re, Gs^Em, Gs, Gs, Gs^Em, Re, Re, Re, Gll^Fdf, Gg, Gg, Gg, Gg^Gvs, Gg^Gvs, Gg^Gvs, Gg, Gs^Emf, Gll^Fp, Gll^Fp, Gll^Fp, Gll^Fp, Gll^Fp, Gll^Fp, Gll^Fp
Gd, Gd, Hh, Hh, Gll, Gll^Fdf, Gll, Gll^Fdf, Gd, Gd, Hh, Gg, Gg, Gg, Gs, Gg, Gs, Gg, Gll^Fdf, Gll^Fdf, Gg, Gs, Re, Gd, Gd^Es, Gs, Gd, Gd, Re, Gll^Fdf, Gll^Fdf, Gg, Re, Gg, Gg, Gg^Gvs, Gg, Gg, Gs, Gs^Emf, Gs, Gll^Fp, Gll^Fp, Gll^Fp, Gll^Fp, Gll^Fp
Gd, Hh, Hh, Hh, Gd, Gll, Gs, Gd, Gd^Em, Hh, Hh, Hh, Hh, Gg, Gg, Gs, Gs, Gg, Gg, Gll^Fdf, Gs^Em, Gs, Re, Re, Re, Gs, Re, Re, Gg, Re, Re, Re, Gs^Emf, Re, Re, Re, Re, Gg, Gg^Efm, Gs, Gs, Gll^Fp, Gll^Fmf, Gll^Fp, Gll^Fmf, Gll^Fmf
Re, Hh, Gd^Emf, Gd^Emf, Gd, Gd, Gs, Gs, Gd^Em, Gd^Em, Gd, Hh, Gg, Gg, Gs, Gs, Gs, Gs, Gg, Gs, Gs^Em, Gs, Re, Gg^Em, Gd, Re, Gg, Gg, Gg^Gvs, Gg, Gg, Gs, Gs, Gs, Gs, Gg^Efm, Gg^Efm, Re, 4 Kv, Gg, Gg^Efm, Gs, Gg^Fet, Gll^Fmf, Gll^Fmf, Gll^Fmf
Hh, Re, Re, Gd^Emf, Gs, Gs, Gs, Gs, Gs, Gd^Em, Gs, Gs, Gg, Gg, Gg, Gs, Gg, Gs, Gg, Gg, Re, Re, Gll^Fdf, Gg^Em, Gd, Gd, Gg, Gg, Gg, Gg^Gvs, Gg, Gs, Gll^Fmf, Gll^Fmf, Gll^Fmf, Gg^Efm, Gg^Efm, Gg^Efm, Gg^Efm, Re, Re, Gs, Gs, Gll^Fmf, Gll^Fmf, Gll^Fmf
Hh, Hh, Hh, Re, Re, Gs, Gs, Gs, Gs, Gs, Gs, Gs, Gd, Gg, Gg, Gg, Gg, Gll^Fdf, Re, Re, Gs, Gll^Fdf, Gg, Gd, Gd, Hh, Gg, Gd, Hh, Gg, Gg, Gll^Fmf, Gll^Fmf, Gll^Fmf, Gll^Fmf, Gg^Fet, Gg^Efm, Gg^Efm, Gg, Gg, Re, Gs, Gll, Gll^Fmf, Gll^Fmf, Gll^Fmf
Mm, Hh, Hh, Hh, Gd, 5 Kud, Re, Gs, Gs, Gs, Gd^Em, Gd^Em, Hh, Gd, Gg, Gg, Gd, Gll^Fdf, Re, Gs, Gs, Gs, Gg, Gd, Gd, Gd, Gg, Gd, Gd, Gd, Gs, Gll^Fmf, Gll^Fmf, Gll^Fmf, Gll^Fmf, Gll^Fmf, Gll^Fmf, Gg, Gs^Em, Gs, Gs, Re, Re, Gll^Em, Gll^Em, Gll^Fmf
Mm, Mm, Mm, Hh, Gd, Gd, Gs, Re, Re, Re, Re, Hh, Hh, Hh, Hh, Gd, Gd, Gd, Re, Gs, Gs, Gs, Gg, Gg, Ww, Ww, Ww, Ww, Ww, Ww, Gs, Gs, Gll^Fmf, Gll^Fmf, Gll^Fmf, Gll^Fmf, Gll^Fp, Gll^Fp, Gll^Fp, Gs^Em, Gll, Gll, Re, Gll, Gll^Em, Gg
Mm, Mm, Hh, Hh, Gd^Emf, Gd, Gs, Gs, Gd, Hh, Hh, Re, Re, Hh, Hh, Gd, Re, Re, Gg, Gs, Gg, Gg, Gg, Ww, Gg, Gg, Gg, Gg, Gs, Gs, Gs, Gs, Gg, Gg^Fet, Gll^Fp, Gll^Fp, Gll^Fp, Gll^Fp, Gll^Fp, Gll^Fp, Gll, Gll^Em, Gll, Re, Re, Gll
Hh, Hh, Hh, Gd^Emf, Gd^Emf, Gd, Gs, Gs, Gd, Hh, Hh, Hh, Re, Hh, Re, Re, Gd, Gd, Gd, Gll^Fdf, Gg, Gg, Gs, Ww, Ww, Gg, Gg, Gg, Gs, Gs, Gd, Hh, Gd, Gg, Gll^Fp, Gll^Fp, Gll^Fp, Gll^Fp, Gll^Fp, Gll^Fp, Gll, Gll, Gg, Gg^Efm, Gg^Efm, Re
Hh, Hh, Gs, Gd, Gs, Gs, Gs, Gs, Gd, Hh, Re, Re, Gg, Re, Gg, Gd, Gd, Gd, Gd, Gs, Gs, Gs, Gs, Ww, Ww, Gg, Gg, Gg, Gg, Gd, Re, Gd, Gs, Gll, Gll^Em, Gll^Fp, Gll^Fp, Gll^Fp, Gs^Em, Gll, Gg, Gg, Gg, Gg^Efm, Re, Re
Gs, Gs, Gs, Gs, Gs, Gs, Gg, Gs, Re, Re, Gs, Gs, Gg, Gg, Gg, Gg, Gll^Fdf, Gd, Gg, Gs, Gs, Gs, Gs, Gs, Gg, Ww, Ww, Gg, Re, Re, Hh, Re, Gs, Gll, Gll, Gll^Em, Gs, Gs, Gs, Gs, Gs, Gg, Re, Re, Hh, Gd
Gs, Gs, Gs, Gg, Gll^Fdf, Gll^Fdf, Gg, Gg, Re, Gs, Gs, Gs, Gg, Gg, Gg, Gll^Fdf, Gs, Gll^Fdf, Gg, Gg, Gg, Gs, Gg^Es, Gg^Es, Gg, Gg, Ww^Bw/, Ww^Bw/, Gg, Gd, Gd, Re, Re, Gs, Gs, Gs, Gs, Gs^Em, Gs, Gs, Gg, Re, Gg, Gd, Gd, Gd
Gg, Gg, Gg, Gg, Gll^Fdf, Gll^Fdf, Gs, Gs, Re, Gs, Gs, Gs, Gg, Gg, Gg, Gs, Gs, Gs, Gs, Gg, Re, Gg, Re, Gg, Re, Re, Gg, Ww, Gg, Gd, Gs, Gs, Gd, Re, Re, Gg, Gg, Gg, Gg^Efm, Gg, Gg, Re, Gg^Efm, Gg, Gs, Gg
Gg, Gg, Gg, Gg, Gs, Gs, Gs, Gs, Re, Gs, Gs, Gg, Gll^Fdf, Gg, Re, Gs, Re, Gs, Re, Re, Gs, Re, Gll^Fdf, Re, Gg, Gg^Es, Gg, Ww, Ww, Gs, Gs, Gs, Gd, Hh, Re, Gs, Gg^Efm, Gg^Efm, Gg^Efm, Gg^Efm, Re, Re, Gg, Gg, Gs, Gs
Gg, Gs, Gs, Gs, Gs, Gs, Gs, Hh, Re, Re, Re, Gs, Re, Re, Gg, Re, Gg, Re, Gs, Gs, Gs, Gg, Gg, Gs, Gs, Gg, Gg, Gg, Ww, Gs, Ww, Gs, Gg, Gd, Gs, Re, Re, Gg^Efm, Re, Re, Gg^Efm, Gg, Gg, Gs, Gs, Gs
Gs, Gs, Gs, Gs, Gs, Hh, Gd, Re, Gd, Hh, Gs, Re, Gll^Fdf, Gg, Gg, Gs, Gs, Gs, Gs, Gs, Gs, Gg, Gg, Gs, Gg^Em, Gs, Gs, Gg, Gg, Ww, Gg, Ww, Ww^Ewf, Gg, Ww, Gs, Gs, Re, Gg^Efm, Gg^Efm, Gg, Gg, Ww, Ww^Ewf, Ww, Gs
Gs, Gs, Hh, Hh, Gd, Gd, Gd, Re, Gd, Gd, Gd, Gs, Gg, Gg, Gs, Gs, Gll^Fdf, Gs, Gs, Gs, Gs, Gg, Gg, Gg, Gg, Gs, Gs, Gs, Gs, Gg, Gg, Ww^Ewl, Ww^Ewf, Ww, Ww, Ww^Ewf, Ww^Ewl, Gg, Gg, Gg, Ww, Ww^Ewf, Ww, Ww, Ww^Ewf, Ww
Re, Re, Re, Hh, Gd, Gd, Re, 2 Ko, Re, Gd, Gd, Hh, Gg, Gs, Gs, Gll^Fdf, Gll^Fdf, Gll^Fdf, Gs, Gs, Gs, Gg^Emf, Gs, Gs, Gs, Gg, Gg, Gg^Em, Gg, Gg, Gg, Gg, Gg, Gg, Gg, Ww^Ewl, Ww, Ww, Ww, Ww^Ewl, Ww^Ewf, Ww, Gg, Gg, Gg, Ww^Ewl
Gs, Gs, Gs, Re, Re, Re, Gs, Gs, Gd, Re, Re, Gg, Gg, Gs, Re, Gll^Fdf, Gll^Fdf, Gll^Fdf, Gs, Gs, Gg^Emf, Gg, Gg, Gs, Gg^Emf, Gg, Gll, Gg, Gll, Gg, Gll^Fp, Gs, Gs, Gs, Gg, Gg, Gs, Gs, Gs, Gg, Gg, Gg, Gg, Gg, Gg, Gg
Hh, Gs, Hh, Gs, Gs, Gs, Gd, Gs, Gd, Hh, Hh, Re, Re, Re, Gs, Re, Re, Gll^Fdf, Gs, Gs, Gg, Gg, Gg, Gg^Emf, Gll, Gll, Gll, Gll, Gll^Fp, Gll^Fp, Gll^Fp, Gll^Fp, Gll^Fp, Gs, Gg^Fet, Gs, Gll^Fmf, Gs, Gs, Gs, Gs, Gg, Gg, Gg, Gg, Gg
Hh, Hh, Hh, Hh, Hh, Gs, Gd, Gd, Gd, Hh, Gd, Gd, Gs, Gs, Gll^Fdf, Gs, Re, Gs, Gs, Gs, Gg^Emf, Gg, Gg, Gg, Gll, Gll, Gll, Gll^Fp, Gll^Fp, Gll^Fp, Gll^Fp, Gll^Fp, Gll^Fp, Gll^Fp, Gll^Fmf, Gll^Fmf, Gll^Fmf, Gll^Fmf, Gll^Fmf, Gll^Fmf, Gg^Fet, Gs, Gs, Gg, Gg, Gg
Md, Md, Md, Md, Md, Hh, Hh, Gd, Gd, Gd, Gd, Gd, Gll^Fdf, Gll^Fdf, Gll^Fdf, Gs, Re, Gs, Gg, Gg^Emf, Gg^Emf, Gg, Gg, Gg, Gll, Gll, Gll, Gll^Fp, Gll^Fp, Gll^Fp, Gll^Fp, Gll^Fp, Gll^Fp, Gll^Fp, Gll^Fmf, Gll^Fmf, Gll^Fmf, Gll^Fmf, Gll^Fmf, Gll^Fmf, Gll^Fmf, Gll, Gll, Gs, Gs, Gg
Md, Md, Md, Md, Md, Hh, Hh, Gd, Gd, Gd, Gd, Gs, Gg, Gll^Fdf, Gg, Gs, Re, Gg, Gg, Gg, Gg, Gg, Gg, Gg, Gg, Gll, Gg, Gll^Fp, Gg, Gll^Fp, Gll^Fp, Gll^Fp, Gll^Fp, Gll^Fp, Gll^Fmf, Gll^Fmf, Gll^Fmf, Gll^Fmf, Gll^Fmf, Gll^Fmf, Gll^Fmf, Gll, Gll, Gs, Gg, Gg
