border_size=1
usage=map

Gs          , Gs          , Gs          , Gs          , Gg          , Gg          , Hh          , Hh          , Mm          , Mm          , Mm          , Gg          , Mm          , Mm          , Mm          , Hh          , Hh          , Gg          , Gg          , Gg          , Gg          , Gg          , Gg          , Gg          , Gg          , Gg          , Gg          , Gg          , Gg          , Gg          , Gg          , Rrc         , Gg          , Gg          , Gg^Efm      , Gg          , Gg          , Gg          , Gg          , Gg          , Gg          , Gg          , Gg          , Gg          , Gs          , Gs          , Gs          
Gs          , Gs          , Gs          , Gs          , Gg^Emf      , Gg^Emf      , Hh          , Hh          , Mm          , Mm          , Mm          , Mm          , Mm          , Mm          , Mm          , Hh          , Hh          , Hh          , Gg          , Gg          , Gg          , Gg          , Gg          , Gg          , Gg          , Gg          , Gg          , Gg          , Gg          , Gg          , Gg          , Rrc         , Gg          , Gg^Efm      , Gg^Efm      , Gg^Efm      , Gg          , Gg          , Hh          , Gg          , Gg          , Gg          , Gg          , Gg          , Gs          , Gs          , Gs          
Gs          , Gs          , Gg          , Gg          , Gg^Emf      , Hh          , Hh          , Hh          , Mm          , Mm          , Mm          , Mm          , Mm          , Mm          , Mm          , Hh          , Hh          , Hh          , Gg^Emf      , Gg          , Gg          , Gg          , Gg          , Gg          , Gg          , Gg          , Gg          , Gg          , Gg          , Gg          , Gg          , Rrc         , Rrc         , Gg          , Gg          , Gg          , Gg          , Hh          , Gs          , Gg^Eff      , Gg^Eff      , Gg          , Gg          , Gg          , Gg          , Gs          , Gg          
Gg          , Gg          , Gs          , Gs          , Gs          , Hh          , Hh          , Hh          , Mm          , Mm          , Mm          , Mm          , Mm          , Mm          , Mm          , Hh          , Hh          , Gg^Emf      , Gg          , Gg          , Gg          , Gg          , Gg          , Gg          , Gg          , Gg          , Gg          , Gg          , Gg          , Gg          , Gg          , Gg          , Rrc         , Gs          , Gs          , Gs          , Rrc         , Gg          , Gg          , Gs          , Gg          , Gg          , Rrc         , Gs          , Gs          , Gg          , Rrc         
Gg          , Gs          , Gs          , Gs          , Gs          , Hh          , Hh          , Hh          , Mm          , Mm          , Mm          , Mm          , Mm          , Mm          , Hh          , Hh          , Hh          , Gg^Emf      , Gg          , Gg          , Gg          , Gg          , Gg          , Gg          , Gg          , Gg          , Gg          , Gg          , Gg          , Gg          , Gg^Eff      , Gg^Eff      , Gs          , Rrc         , Rrc         , Rrc         , Gg          , Rrc         , Rrc         , Gg          , Rrc         , Rrc         , Gg          , Rrc         , Rrc         , Rrc         , Gs          
Gg          , Gs          , Gg          , Gs          , Gg          , Gg^Emf      , Hh          , Hh          , Hh          , Mm          , Mm          , Mm          , Hh          , Hh          , Hh          , Hh          , Gg          , Gg          , Gg          , Gg          , Gg          , Gg          , Gg          , Gg          , Gg          , Gg          , Gg          , Gg          , Gg          , Gg          , Gg          , Gg          , Gg          , Gs          , Gg          , Gg          , Gg          , Gg          , Gg          , 1 Kh        , Gg          , Gg          , Gg          , Gs          , Gs          , Gs          , Gs          
Gg          , Gg          , Gg          , Gg          , Gg          , Gg          , Gd          , Gd^Emf      , Hh          , Hh          , Hh          , Mm          , Hh          , Hh          , Gg          , Gg^Emf      , Gg          , Gg          , Gg          , Gg          , Gg          , Gg          , Gg          , Gg          , Gg          , Gg          , Gg^Efm      , Gg^Efm      , Gg^Efm      , Gg          , Gg^Eff      , Gg          , Gg          , Gg          , Gg          , Gg          , Gg          , Gg          , Gg          , Rrc         , Gg          , Gg          , Gs          , Gg          , Gg          , Gs          , Gg          
Gs          , Gg          , Gs          , Gg          , Gs          , Gg          , Gd          , Gd^Emf      , Gd^Emf      , Hh          , Gd^Emf      , Hh          , Gg          , Gg          , Gg          , Gg          , Gg          , Gg          , Gg          , Gg          , Gg          , Gg          , Gg          , Gg          , Gg          , Gg          , Gg^Efm      , Gg^Efm      , Gg^Efm      , Gg^Efm      , Gg          , Gg^Eff      , Gg          , Gs          , Gs          , Gs          , Gs          , Gg          , Rrc         , Rrc         , Gg          , Gs          , Gg          , Gg          , Hh          , Gg          , Gg          
Rp          , Gs          , Gs          , Gs          , Rp          , Rp          , Rp          , Gd          , Gd^Emf      , Gd^Emf      , Gd          , Gd          , Gd          , Gg          , Gg          , Gg          , Gg          , Gg          , Gg          , Gg          , Gg          , Gg          , Gg          , Gg          , Gg          , Gg          , Gg          , Gg          , Gg          , Gg          , Rrc         , Gg          , Rrc         , Gs          , Gs          , Gs          , Rrc         , Rrc         , Gg          , Gg          , Gg          , Gg          , Gg          , Hh          , Hh          , Gg          , Gg          
Gs          , Rp          , Rp          , Rp          , Gg          , Gg          , Gs          , Rp          , Rp          , Gd          , Gd          , Gd          , Gs          , Gs          , Gs          , Gg          , Gg          , Gg          , Gg          , Gg          , Gg          , Gg          , Gg          , Gg          , Gg          , Gg          , Gg          , Gg          , Rrc         , Rrc         , Gg          , Rrc         , Gs          , Rrc         , Rrc         , Rrc         , Gs          , Gg^Eff      , Gg^Eff      , Gg          , Gg          , Gg          , Gg          , Gg          , Gg          , Gg          , Gg          
Gs          , Gs          , Gs          , Gg          , Gg          , Gs          , Gs          , Gs          , Gs          , Rp          , Rp          , Gd          , Gs          , Gs          , Gs          , Gs          , Gg          , Gg          , Gg          , Gg          , Gg          , Gg          , Gg          , Gg          , Gg          , Gg          , Rrc         , Rrc         , Gs          , Gg          , Gg          , Gg^Es       , Gg^Es       , Gs          , Rrc         , Gs          , Gs          , Gg          , Gg          , Gg          , Gll         , Gg          , Gg          , Gg          , Gg          , Gg          , Gg          
Gg          , Gs          , Gg          , Gg          , Gg          , Gs          , Gs          , Gs          , Gg^Es       , Gg          , Gs          , Rp          , Rp          , Gs          , Gs          , Gs          , Gg          , Gg          , Gd          , Gg          , Gg          , Gg          , Gg          , Gg          , Rrc         , Rrc         , Hh          , Gs          , Gg          , Gg          , Gg          , Gg^Es       , Gg          , Gg          , Rp          , Gs          , Gs          , Gg          , Gll^Em      , Gll         , Gll         , Gll         , Gll         , Gll         , Gg          , Gg          , Gg          
Gs          , Gg          , Gg          , Gg          , Gg          , Gs          , Gs          , Gs          , Gg          , Gg^Es       , Gs          , Gs          , Hh          , Rp          , Gd          , Gd          , Gd          , Gd          , Gd          , Gd          , Gg          , Gg          , Gg          , Gg          , Rrc         , Hh          , Gs          , Gg          , Gg          , Gg          , Gg          , Gg          , Gg          , Gg          , Gg          , Rp          , Gg          , Gg          , Gg          , Gll^Em      , Gll^Fp      , Gll^Fp      , Gll^Fp      , Gll^Fp      , Gg          , Gg          , Gg          
Gs          , Gs          , Gs          , Gg          , Gg          , Gg          , Gg          , Gg          , Gg          , Gg          , Gg          , Hh          , Hh          , Rp          , Gd          , Gd          , Gd          , Gd          , Gd          , Gd          , Hh          , Gg          , Gg          , Gg          , Rrc         , Gs          , Gs          , Gg          , Gg          , Gg          , Gg          , Gg          , Gg          , Gg          , Gg          , Rp          , Rp          , Gg          , Gg^Fet      , Gll^Fp      , Gll^Fp      , Gll^Fp      , Gll^Fp      , Gll^Fp      , Gll^Fp      , Gg          , Gg          
Gs          , Gs          , Gs          , Gs          , Gg          , Gg          , Gg          , Gg          , Gg          , Gg          , Gg          , Hh          , Rp          , Rp          , Rp          , Gd          , Rp          , Gd          , Gd          , Hh          , Hh          , Hh          , Rrc         , Rrc         , Gg          , Gg          , Gg          , Gg          , Gg          , Gg          , Gll         , Gll         , Gll^Em      , Gg          , Gg^Fet      , Gg          , Gg^Efm      , Rp          , Gg^Efm      , Gg^Efm      , Gg^Efm      , Gll^Fp      , Gll^Fp      , Gll^Fp      , Gll^Fmf     , Gg          , Gg          
Gs          , Gs          , Gg          , Gg          , Rp          , Gs          , Gs          , Gs          , Gs          , Gg          , Rp          , Rp          , Gg          , Hh          , Gg          , Rp          , Gg          , Rp          , Rp          , Rp          , Rp          , Rrc         , Gs          , Gs          , Gg          , Gg          , Gg          , Gg          , Gs          , Gs          , Gll         , Gll         , Gll^Fp      , Gll^Fp      , Gll^Fp      , Gg^Efm      , Gg^Efm      , Rp          , Gg^Efm      , Gg^Efm      , Gg          , Gs          , Gg^Fet      , Gll^Fmf     , Gll^Fmf     , Gll^Fmf     , Gg          
Gg          , Gg          , Rp          , Rp          , Gg          , Rp          , Rp          , Gs          , Rp          , Rp          , Gg          , Gg          , Gg          , Gg          , Gg          , Gg          , Gg          , Gg          , Gg          , Gs          , Gs          , Rp          , Rp          , Gs          , Gg          , Gg          , Gg          , Gs          , Gs          , Gs          , Gll^Fp      , Gll^Fp      , Gll^Fp      , Gll^Fp      , Gll^Fp      , Gll         , Gll         , Rp          , Rp          , Gg          , Gg          , Gs          , Gll         , Gll^Fmf     , Gll^Fmf     , Gll^Fmf     , Gg          
Rp          , Rp          , Gs          , Gs          , Gg          , Gg          , Gg          , Rp          , Gs          , Gs          , Gg          , Gg          , Gg^Gvs      , Gg          , Gs          , Gg          , Gs          , Gg          , Gg          , Gs          , Gs          , Gs          , Gg^Es       , Rp          , Gg          , Gg          , Gg          , Gg          , Gg          , Gs          , Gll^Fp      , Gll^Fp      , Gll^Fp      , Gll^Fp      , Gg^Fet      , Gll         , Gll         , Gll         , Gs          , Rp          , 3 Kv        , Gg          , Gll         , Gll         , Gg^Fet      , Gs          , Gs          
Gs          , Gs          , Gs          , Gs          , Gg          , Gg          , Gg^Em       , Gs          , Gs          , Gs          , Gg          , Gg^Gvs      , Gg^Gvs      , Gg^Gvs      , Gs          , Gs          , Gs          , Gs          , Gg^Gvs      , Gg          , Gg          , Gg          , Gg^Es       , Rp          , Gs          , Gs          , Gs          , Gg          , Gg          , Gg          , Gg          , Gll^Fp      , Gll^Fp      , Gll^Fp      , Gll^Fmf     , Gll^Fmf     , Gll^Fmf     , Gs          , Gg          , Gs          , Gg          , Rp          , Rp          , Gll^Em      , Rp          , Gs          , Gg^Es       
Gs          , Gs          , Gg          , Gg          , Gg          , Gg^Em       , Gg^Em       , Gg^Em       , Gg          , Gs          , Gg          , Gg          , Gg          , Gg          , Gg^Em       , Gs          , Gg          , Gg^Gvs      , Gg^Gvs      , Gg^Gvs      , Gg          , Gg          , Gg          , Rp          , Rp          , Gs          , Gs          , Gg          , Gg          , Gg          , Gg          , Gll^Fp      , Gll^Fp      , Gll^Fp      , Gll^Fmf     , Gll^Fmf     , Gll^Fmf     , Gg^Fet      , Gg          , Gg          , Gg          , Gg          , Gg          , Rp          , Gg          , Rp          , Rp          
Gg          , Gg          , Gg          , Gg          , Gg          , Gg          , Gg          , Gg          , Gg          , Gg          , Gg          , Gg          , Gg          , Gg^Em       , Gg^Em       , Gg^Em       , Gg          , Gg          , Gg          , Gg          , Gg          , Gg          , Gll^Fp      , Gll         , Gll         , Rp          , Rp          , Gg          , Gg^Es       , Gg          , Gg          , Gg          , Gg          , Gg          , Gg          , Gll^Fmf     , Gg          , Gg          , Gs          , Gg          , Gg^Es       , Gg          , Gs          , Gg          , Gg^Emf      , Gg          , Gg          
Gg          , Gg          , Gg          , Gg          , Gg          , Gg          , Gs          , Gs          , Gll         , Gg          , Gg          , Gg          , Gg          , Gg          , Gg          , Gg          , Gg          , Gg          , Gg          , Gg          , Gg          , Gg          , Gll^Fp      , Gll^Fp      , Gll^Fp      , Gs          , Gs          , Rp          , Gg^Es       , Gs          , Gs          , Gg          , Gg          , Gg          , Gg          , Gg          , Gg^Emf      , Gg^Emf      , Gs          , Gs          , Gg          , Gs          , Gg          , Gg^Emf      , Gg^Emf      , Gg          , Gg          
Gd          , Gd          , Gd          , Gg          , Gd          , Gs          , Gs          , Gs          , Gll         , Gll         , Gll         , Gll         , Gs          , Gs          , Gs          , Gg          , Gg          , Gg          , Gg          , Gg          , Gg          , Gg          , Gll         , Gll^Fp      , Gll         , Gs          , Rp          , Rp          , Rp          , Gs          , Gs          , Gs          , Gg          , Gg          , Gg          , Gg          , Gg          , Gg^Emf      , Gs          , Gs          , Gg^Fet      , Gs          , Gll^Fp      , Gg          , Gg          , Gg          , Gg          
Gd          , Gd          , Hh          , Gd          , Gd          , Gd          , Gs          , Gs          , Gll^Fp      , Gll^Fmf     , Gll^Fp      , Gll         , Gs          , Gs          , Gll         , Gg          , Gll^Fmf     , Gg          , Gg          , Gg          , Gg          , Gs          , Gs          , Gll         , Rp          , Rp          , Gs          , Gs          , Gs          , Rp          , Rp          , Gg          , Gg          , Gg          , Gg          , Gg          , Gg          , Gg          , Gll^Fp      , Gll^Fp      , Gll^Fp      , Gll^Fp      , Gll^Fp      , Gll^Fmf     , Gll^Fmf     , Gg^Fet      , Gg          
Hh          , Hh          , Hh          , Hh          , Hh          , Gd          , Gll^Fp      , Gll^Fmf     , Gll^Fmf     , Gll^Fmf     , Gll^Fp      , Hh          , Hh          , Hh          , Gll         , Gll         , Gll^Fmf     , Gll^Fmf     , Gs          , Gg          , Rp          , Gs          , Rp          , Rp          , Gg          , Gs          , Gs          , Gs          , Gs          , Gg          , Gg          , Rp          , Rp          , Gg          , Gg          , Gg          , Gg          , Gg          , Rp          , Gll^Fp      , Gll^Fp      , Gll^Fp      , Gll^Fmf     , Gll^Fmf     , Gll^Fmf     , Gll^Fmf     , Gg          
Mm          , Mm          , Mm          , Hh          , Hh          , Hh          , Gll^Fp      , Gll^Fmf     , Gll^Fp      , Gll^Fmf     , Gs          , Hh          , Hh          , Hh          , Gg          , Gll         , Gs          , Gs          , Rp          , Rp          , Gs          , Rp          , Gg          , Gg          , Gg          , Gg          , Gg          , Gg          , Gg          , Gg          , Gll^Fp      , Gll^Fp      , Gll^Fp      , Rp          , Rp          , Gg          , Rp          , Rp          , Gg          , Rp          , Rp          , Gll^Fmf     , Gll^Fmf     , Gll^Fmf     , Gll^Fmf     , Gll^Fmf     , Gg          
Mm          , Mm          , Mm          , Mm          , Hh          , Hh          , Gll         , Gll         , Gll         , Gll         , Gs          , Gs          , Gs          , Gg          , Rp          , Gg          , Rp          , Rp          , Gd          , Gs          , Gs          , Gg          , Gll^Fp      , Gg          , Gll         , Gg          , Gll         , Gg          , Gll^Fp      , Gll^Fp      , Gll^Fp      , Gll^Fp      , Gll^Fp      , Gll^Fp      , Gll^Fmf     , Rp          , Gg          , Gg          , Gg          , Gg          , Gg          , Rp          , Rp          , Gll^Fmf     , Gll^Fmf     , Gll^Fmf     , Gg          
Mm          , Mm          , Mm          , Mm          , Hh          , Hh          , Gd          , Gll         , Gd^Dr       , Gll         , Gs          , Gs          , Rp          , Rp          , Hh          , Rp          , Hh          , Gd          , Gd          , Gs          , Gs          , Gll^Fp      , Gll^Fp      , Gll^Fp      , Gll         , Gll         , Gll         , Gll         , Gll^Fp      , Gll^Fp      , Gll^Fp      , Gll^Fp      , Gll^Fp      , Gll^Fp      , Gll^Fmf     , Gll^Fmf     , Gg          , Gg          , Gg          , Gg          , Gg          , Gg          , Gg          , Rp          , Rp          , Gg          , Gg          
Mm          , Mm          , Hh          , Hh          , Gd          , Gd          , Gs          , Gs          , Gd          , Gd          , Rp          , Rp          , Gs          , Gs          , Hh          , Hh          , Hh          , Gd          , Gg          , Gs          , Gs          , Gll^Fp      , Gg          , Gll         , Gll         , Gll         , Gg          , Gll         , Gg          , Gll^Fp      , Gll^Fp      , Gll^Fp      , Gll^Fmf     , Gll^Fmf     , Gll^Fmf     , Gll^Fmf     , Gll         , Gg          , Gg          , Gg          , Gg          , Gg          , Gg          , Gg          , Gg          , Rp          , Rp          
Mm          , Mm          , Hh          , Hh          , Gd          , Gs          , Gs          , Gs          , Rp          , Rp          , Gd          , Gd          , Gs          , Gs          , Gd          , Hh          , Gs          , Gs          , Gs          , Gs          , Gs          , Gg          , Gg          , Gg          , Gg          , Gg          , Gg          , Gg          , Gg          , Gg          , Gg          , Gll^Fmf     , Gll         , Gll^Fmf     , Gll         , Gll         , Gll         , Gg          , Gg          , Gg          , Gg          , Gg          , Gg          , Gg          , Gg          , Gg          , Gg          
Hh          , Hh          , Hh          , Hh          , Gd          , Gg^Dr       , Gg          , Gg          , Rp          , Gd          , Gd          , Gd^Dr       , Gs          , Gd          , Gd          , Gd          , Gd          , Gs          , Gs          , Gs          , Gs          , Gs          , Gs          , Gg          , Gg          , Gg          , Gg          , Gg          , Gg          , Gg          , Gg          , Gg          , Gg          , Gll         , Gll         , Gll         , Gg          , Gg          , Gg          , Gg          , Gg          , Gg          , Gg          , Gg          , Gg          , Gg          , Gg          
Hh          , Hh          , Gd^Em       , Gd          , Gd          , Gd          , Gd          , Gg          , Rp          , Gs          , Gs          , Gs          , Gs          , Gd          , Gd          , Gd          , Gs          , Gs          , Gs          , Gs          , Gs          , Gs          , Gs          , Gg          , Gg          , Gg          , Gg          , Gg          , Gg          , Gg          , Gg          , Gg          , Gg          , Gg          , Gg          , Gg          , Gg          , Gg          , Gg          , Gg          , Gg          , Gg          , Gg          , Gg          , Gg          , Gg          , Gg          
Gs          , Gs          , Gd^Em       , Gd^Em       , Gd          , Gd          , Rp          , 2 Ko        , Gg          , Gs          , Gs          , Gs          , Gs          , Gd          , Hh          , Gd          , Hh          , Gs          , Hh          , Gs          , Gd          , Gs          , Gs          , Gg          , Gg          , Gg          , Gg          , Gg          , Gg          , Gg          , Gg          , Gg          , Gg          , Gg          , Gg          , Gg          , Gg          , Gg          , Gg          , Gg          , Gg          , Gg          , Gg          , Gg          , Gg          , Gg          , Gg          
Gg          , Gs          , Gs          , Gd          , Rp          , Rp          , Gg          , Gg          , Gd          , Gd          , Gd          , Gs          , Hh          , Hh          , Mm          , Hh          , Mm          , Hh          , Mm          , Hh          , Hh          , Gd          , Gd          , Gg          , Gg          , Gg          , Gg          , Gg          , Gg          , Gg          , Gg          , Gg          , Gg          , Gg          , Gg          , Gg          , Gg          , Gg          , Gg          , Gg          , Gg          , Gg          , Gg          , Gg          , Gg          , Gg          , Gg          
Gg          , Gs          , Gs          , Gs          , Rp          , Gs          , Gs          , Gs          , Gs          , Gd          , Hh          , Hh          , Mm          , Mm          , Mm          , Mm          , Mm          , Mm          , Mm          , Hh          , Hh          , Hh          , Gd          , Gd          , Gd          , Gg          , Gg          , Gg          , Gg          , Gg          , Gg          , Gg          , Gg          , Gg          , Gg          , Gg          , Gg          , Gg          , Gg          , Gg          , Gg          , Gg          , Gg          , Gg          , Gg          , Gg          , Gg          
Rp          , Rp          , Rp          , Rp          , Gd          , Gd          , Gd          , Gs          , Hh          , Hh          , Mm          , Mm          , Mm          , Mm          , Mm          , Mm          , Mm          , Mm          , Mm          , Mm          , Hh          , Hh          , Gd          , Gd          , Gg          , Gg          , Gg          , Gg          , Gg          , Gg          , Gg          , Gg          , Gg          , Gg          , Gg          , Gg          , Gg          , Gg          , Gg          , Gg          , Gg          , Gg          , Gg          , Gg          , Gg          , Gg          , Gg          
Gg          , Gg          , Gg          , Gd          , Gd          , Gd          , Gd          , Hh          , Mm          , Mm          , Mm          , Mm          , Mm          , Mm          , Mm          , Mm          , Mm          , Mm          , Mm          , Mm          , Mm          , Hh          , Hh          , Gd          , Gg          , Gg          , Gg          , Gg          , Gg          , Gg          , Gg          , Gg          , Gg          , Gg          , Gg          , Gg          , Gg          , Gg          , Gg          , Gg          , Gg          , Gg          , Gg          , Gg          , Gg          , Gg          , Gg          
